+==========|==========+
|..........|..........|
|@[#].[##].|.[##].[#]@|
|.....................|
|.===.|.===+===.|.===.|
|.....|....|....|.....|
+===+.+==..|..==+.+===+
    |.|.........|.|    
    |.|..+= =+..|.|    
+===+....|   |....+===+
.........|   |.........
+===+.+..+===+..+.+===+
    |.|.... ....|.|    
    |.|..==+==..|.|    
+===+.+....|....+.+===+
|..........|..........|
|.==+.+==+...+==+.+==.|
|@..|.............|..@|
+==.+.+..==+==..+.+.==+
|.....|....|....|.....|
|.====+===...===+====.|
|.....................|
+=====================+
