#######################
#                     #
# ### #### # #### ### #
#                     #
# ### # ####### # ### #
#     #    #    #     #
##### ###  #  ### #####
    # #         # #    
    # #  ## ##  # #    
#####    #   #    #####
         #   #         
##### #  ## ##  # #####
    # #         # #   
    # #  #####  # #   
##### #    #    # #####
#          #          #
# ### ####   #### ### #
#   #             #   #
### # #  #####  # # ###
#     #    #    #     #
# ########   ######## #
#                     #
#######################
